Heelo Codevval | Hello Codeeval
hELLO cODEEVAL | Hello Codeeval
Hello Codeeval | Hello Codeeval
abclo Codeeval | Hello Codeeval
q Codeeval | Hello Codeeval
wdDQbQLZjOeQWwxVdKgCRoCYFzopZtgop | oFCeZgodpdDYVLQwzRObxoKwQtQpgCjWZ
aqQzkdWESygPNsnxcmdrSBmlDBo | ymlSQakSndzmqNWPDsBxEgBordc
qzZsTIgwvj | ITzgvZsjwq
ohBDbCqstfKVNTXVGtcpCqS | bXKhsBqCcNCVqSTDofGptVt
tNbFNCILtz | NCzbtFLtNI
nCsQTXyD | QsnXCDTy
CRQwGroDV | wQoVrGDRC
pGWFivLUzRpAuXM | vXpUWFLAMizpRGu
ZqEciQHXCnKkibyFJPJwdyX | cJHFkCPqQJbXKXnEdyiZywi
wLxOiekWXvVEoUWZiP | LkVviwEOxiWUXeWPoZ
CyardxsfIyEHPaNyD | DEHyCIryyNaasxfPd
qGGBQZXEiCu | QXEiqGGCuZB
vofyYmgsnTEiWnDOeXWetpXGYLYSLTqNRJDhrOM | DLfWYhDqyitLXYYOvWSMTnTspgoONJRenrXEemG
k NLVIOkFyIlfptN | Fkplfy LINtVkNIO
bZxvycLm | yZmcvLbx
MJiJGVvaxgdcPJLxmEruP | vmEuxgrJiGMJaLcJPPVxd
CueZATpoVFDdycidonUgSMJL | ooFuACLMJSgeVUdydiTZDpnc
hELLO cODEEVAL | Hello Codeeval
PDXTXwqeOCMdiYCPeZOxNkTxfswJNrHN | wDqHiwrkJNPfOXPeZNsYNxTCeXOMTxdC
ijzfujmBu | umzjifBuj
ezYqAsxQLqAEDbXW tKZzvdN | tdKseLAYNQWAXvzqbDqx zZE
dpGjgBXaSzovE HGqbvGMHVcgJpzOV | HOEzvbMppHcagvSVGoGqzXjV GgdJB
CAABRnoPVxwIXVhnyjyhqAAAxYgvVR | VAYAyjhXxnBPoVAnxRgIVqyvAhAwCR
OXWEfeCadtYfRXtKEkmUpvqJHMg | kvOJqffRXECYtpWdKXgemMUtEHa
EJwhqEgjqYhMYRALnJeZOS | AjJMgRYJZneqSLqOEhhYwE
Heelo Codevval | Hello Codeeval
vhFryadMENwg | ywFrvdgaEMNh
bMt AsQPnsvaSQf | fQv nQsSstbAPMa
aYwvvqzcAFVSCkHuJEgqKGVwJo ilUixzrpKBStW | Vu twCcAHqilzJKBgzakoYWrvJSiFESGVqvwKxpU
ZFxGF | ZFFGx
xeASOzDynKAMIFUAyLoQY | zSLUMnyAIAAOYeFDyKoQx
boViNDHnxUiDzlkJvyboOivPIhAoFYYGwFX | vlXVnkAHyJiDwvooiYhbFDIGFoziOPYNUbx
dEaeqaak | Eakdeaqa
NTZnztDUchjWFxIn | FUcIjnzWxZTDhNnt
VOiGqKKuoDphXQFkI bYoAjEoGxmQPuSS | Y GIkoxuQbopShOqPjQEFGomiXKVKDASu
ADTszQFYTVIaErFGCPiPQte | PTTiGPszrCFVeEtFQIQaAYD
YvlNnqgyqP U NufMCtKiKKHVMvY | MglyKK nKNMPfYYqNutq vViHCvU
Hello Codeeval | Hello Codeeval
WEkjsuIoL GEQgGsVBnwP | QkuBL sIEsPgWVoEjGwnG
JUxIJSqLFcP | LPSJIFxqcUJ